ar	AR
ar-dz	AR
ar-bh	AR
ar-eg	AR
ar-iq	AR
ar-jo	AR
ar-kw	AR
ar-lb	AR
ar-ly	AR
ar-ma	AR
ar-om	AR
ar-qa	AR
ar-sa	AR
ar-sy	AR
ar-tn	AR
ar-ae	AR
ar-ye	AR
cs	CS
cs-cz	CS
da	DA
da-dk	DA
de	DE
de-at	DE
de-ch	DE
de-de	DE
de-lu	DE
el	EL
el-gr	EL
en	EN
en-au	EN
en-be	EN
en-bw	EN
en-ca	EN
en-gb	EN
en-hk	EN
en-ie	EN
en-in	EN
en-nz	EN
en-ph	EN
en-sg	EN
en-us	EN
en-za	EN
en-zw	EN
es	ES
es-ar	ES
es-bo	ES
es-cl	ES
es-co	ES
es-cr	ES
es-do	ES
es-ec	ES
es-es	ES
es-gt	ES
es-hn	ES
es-mx	ES
es-ni	ES
es-pa	ES
es-pe	ES
es-pr	ES
es-py	ES
es-sv	ES
es-us	ES
es-uy	ES
es-ve	ES
fi	FI
fi-fi	FI
fr	FR
fr-be	FR
fr-ca	FR
fr-ch	FR
fr-fr	FR
fr-lu	FR
hu	HU
hu-hu	HU
it	IT
it-ch	IT
it-it	IT
ja	JA
ja-jp	JA
ko	KO
ko-kr	KO
nl	NL
nl-be	NL
nl-nl	NL
no	NO
no-no	NO
nb	NO
nb-no	NO
nn	NO
nn-no	NO
pl	PL
pl-pl	PL
pt	PT
pt-br	PT
pt-pt	PT
ro	RO
ro-ro	RO
ru	RU
ru-ru	RU
ru-ua	RU
sv	SV
sv-fi	SV
sv-se	SV
th	TH
th-th	TH
tr	TR
tr-tr	TR
zh	SC
zh-cn	SC
zh-hk	TC
zh-mo	TC
zh-sg	SC
zh-tw	TC
ms	MS
ms-bn	MS
ms-my	MS
id	ID
id-id	ID

